0 0 -1 -1 -1 -1 -1 -1 -1 -1 -1 -1 0 0 
-1 1 1 1 1 1 1 1 1 1 1 1 1 -1 
-1 2 2 2 2 -1 -1 -1 -1 2 2 2 2 -1 
-1 -1 -1 -1 -1 -1 5 5 -1 -1 -1 -1 -1 -1 
-1 3 3 3 3 3 3 3 3 3 3 3 3 -1 
-1 4 4 4 -1 -1 4 4 -1 -1 4 4 4 -1 
0 4 4 4 -1 5 4 4 5 -1 4 4 4 0 
0 -1 -1 -1 -1 -1 -1 -1 -1 -1 -1 -1 -1 0 
-1 -1 -1 -1 2 0 -1 -1 0 2 -1 -1 -1 -1 
-1 -1 -1 -1 2 0 -1 -1 0 2 -1 -1 -1 -1 
-1 -1 -1 -1 2 0 -1 -1 0 2 -1 -1 -1 -1 
-1 -1 -1 -1 2 0 -1 -1 0 2 -1 -1 -1 -1 
-1 -1 -1 -1 2 0 -1 -1 0 2 -1 -1 -1 -1 
-1 -1 -1 -1 2 0 -1 -1 0 2 -1 -1 -1 -1 
-1 -1 -1 -1 -1 -1 -1 -1 -1 -1 -1 -1 -1 -1 
-1 -1 -1 -1 -1 -1 -1 -1 -1 -1 -1 -1 -1 -1 
-1 -1 -1 -1 -1 -1 -1 -1 -1 -1 -1 -1 -1 -1 
-1 -1 -1 -1 -1 -1 -1 -1 -1 -1 -1 -1 -1 -1 
-1 -1 -1 -1 -1 -1 -1 -1 -1 -1 -1 -1 -1 -1 
-1 -1 -1 -1 -1 -1 -1 -1 -1 -1 -1 -1 -1 -1 
