0000000000001000000000000
0200000000001000000000020
0000000000001000000000000
1111111100001111111110000
0000000000000000000000000
0000000000000000000000000
0000000000000000000000000
0000011110001000111100000
0000000000000000000000000
0000000000000000000000000
0000000000000000000000000
0000000000000000000000000
0000011110001000111100000
0000000000000000000000000
0000000000000000000000000
0000000000000000000000000
0000111111111000011111111
0000000000001000000000000
0200000000001000000000020
0000000000001000000000000



