0000000111100011110000000
0200000000111110000000020
0000000000001000000000000
0000000000001000000000000
0000100000001000000010000
0000111000000000001110000
0000000000000000000000000
0000000000011100000000000
0000000000000000000000000
0000010000000000000100000
1101100001000001000011011
0000000001000001000000000
0000000001101011000000000
0000000000001000000000000
0000000000001000000000000
0000000100000000010000000
0000000010000000100000000
0000100000000000000010000
0200100000001000000010020
0000100000001000000010000



