0000000000000000000000000
0200111000000000001110020
0000111000000000001110000
0000111000000000001110000
0000000000011100000000000
0000000000011100000000000
0000000000011100000000000
0000000000000000000000000
0000001110000000111000000
1101101110000000111011011
0000001110000000111000000
0000000000000000000000000
0000000000011100000000000
0000000000011100000000000
0000000000011100000000000
0000000000000000000000000
0000111000000000001110000
0000111000000000001110000
0200111000000000001110020
0000000000000000000000000



