0000000000000000000000000
0200000000000000000000020
0000010000000000000100000
0000111111000111111110000
0000010000000000000100000
0000010000000000000100000
0000010000000000000100000
0000010000000000000100000
0000010000000000000000000
0000000000011100000000000
0000000000011100000000000
0000000000000000000100000
0000010000000000000100000
0000010000000000000100000
0000010000000000000100000
0000010000000000000100000
0000111111110001111110000
0000010000000000000100000
0200000000000000000000020
0000000000000000000000000



